[
	[
		"3___________2",
		"4           |",
		"4 p         |",
		"4      k    |",
		"4      TT   |",
		"4           |",
		"4    TT     |",
		"4           |",
		"4  TT   s   |",
		"4     WTT   |",
		"4    TT     |",
		"4  TT       |",
		"4         Wd|",
		"1TTTTTTTTTTT0"
	],
	[
		"3________2",
		"4        |",
		"4        |",
		"4      k |",
		"4      T |",
		"4        |",
		"4    TT  |",
		"4  TT    |",
		"4   p   d|",
		"1TTTTTTTT0"
	],
	[
		"3___________2",
		"4          k|",
		"4d          |",
		"4TTTTTT TTT |",
		"4  TTTT     |",
		"4TT   TTTT  |",
		"4   W      W|",
		"4 TTTTTTTTTT|",
		"4           |",
		"4TTTTTTTTTT |",
		"4p          |",
		"4  TTTTTTTTT|",
		"4W          |",
		"1TTTTTTTTTTT0"
	],
	[
		"_____________",
		"_____________",
		"_____________",
		"_____________",
		"3___________2",
		"4ps  W    kd|",
		"1TTTTTTTTTTT0"
	]
]
