[
	[
		"3___________2",
		"7           |",
		"7           |",
		"7      k    |",
		"7      TT   |",
		"7           |",
		"7    TT     |",
		"7           |",
		"7  TT       |",
		"7      TT   |",
		"7    TT     |",
		"7  TT       |",
		"7   p     d |",
		"1TTTTTTTTTTT0"
	],
	[
		"3________2",
		"7        |",
		"7        |",
		"7      k |",
		"7      T |",
		"7        |",
		"7    TT  |",
		"7  TT    |",
		"7   p   d|",
		"1TTTTTTTT0"
	],
	[
		"3___________2",
		"7           |",
		"7        d  |",
		"7 TTTTTTTTTT|",
		"7           |",
		"7TTTTTTTTTT |",
		"7           |",
		"7 TTTTTTTTTT|",
		"7           |",
		"7TTTTTTTTTT |",
		"7           |",
		"7 TTTTTTTTTT|",
		"7p        k |",
		"1TTTTTTTTTTT0"
	],
	[
		"_____________",
		"_____________",
		"_____________",
		"_____________",
		"3___________2",
		"7ps  W    kd|",
		"1TTTTTTTTTTT0"
	]
]
